3 3 3 3 3 3 3 3 3 3 3 3 3 3 3 3 3 3 3 3 3 3 3 3 3 3 3 3 3 3 3 3
6 4 4 5 4 5 4 4 4 5 4 4 4 5 4 4 4 4 4 4 4 4 5 5 5 4 4 4 4 4 4 7
6 4 4 4 3 3 3 3 3 3 3 3 3 3 3 3 3 3 3 3 3 3 3 3 3 3 3 4 4 4 4 7
6 5 4 4 3 4 4 5 4 4 3 4 4 5 4 3 4 3 4 5 4 5 4 4 3 4 3 3 4 5 4 7
6 4 3 4 3 4 5 4 5 4 3 4 5 4 5 5 5 3 5 4 5 4 3 4 4 4 4 3 3 4 5 7
6 4 3 5 3 5 4 3 4 5 3 5 4 3 3 3 4 4 4 3 3 3 3 3 3 5 5 4 3 3 4 7
6 4 3 3 3 4 4 3 5 4 3 4 3 3 4 3 4 3 3 3 4 4 5 4 3 4 4 4 4 3 3 7
6 4 4 4 4 4 3 3 4 5 3 4 4 3 4 3 4 3 5 4 4 4 4 5 3 3 3 3 3 3 3 7
6 4 5 4 3 3 3 4 4 3 3 4 4 3 4 4 4 4 4 3 3 3 3 5 5 5 4 4 4 5 5 7
6 4 4 5 3 4 4 4 3 3 4 4 4 3 3 3 3 4 3 3 4 4 3 3 3 4 5 3 3 3 5 7
6 4 3 3 3 4 3 3 4 4 4 4 5 4 4 4 3 4 3 4 4 4 4 5 3 3 5 3 5 3 5 7
6 4 4 4 3 4 4 3 3 4 4 4 3 3 3 5 3 4 3 4 3 3 5 4 4 3 4 3 5 5 5 7
6 4 4 4 3 3 4 4 4 4 4 4 4 4 3 4 3 4 3 5 5 3 3 3 3 3 4 3 5 3 3 7
6 4 4 4 5 3 3 3 3 3 3 3 3 3 3 3 3 3 3 3 4 4 4 4 4 3 4 3 5 2 2 7
6 4 4 4 5 5 4 4 4 4 4 5 4 4 4 5 4 4 4 4 5 5 5 5 5 4 4 3 5 2 2 7
3 3 3 3 3 3 3 3 3 3 3 3 3 3 3 3 3 3 3 3 3 3 3 3 3 3 3 3 3 3 3 3