3 3 3 3 3 3 3 3 3 3 3 3 3 3 3 3 3 3 3 3 3 3 3 3 3 3 3 3 3 3 3 3
6 4 4 8 4 8 4 4 4 8 4 4 4 8 4 4 4 4 4 4 4 4 8 4 8 4 4 4 4 4 4 7
6 4 4 4 3 3 3 3 3 3 3 3 3 3 3 3 3 3 3 3 3 3 3 3 3 3 3 4 4 3 3 7
6 8 4 4 3 4 4 8 4 4 3 4 4 3 4 3 4 3 4 3 4 8 4 4 3 4 3 3 4 8 3 7
6 4 3 4 3 4 3 4 3 4 3 3 8 4 8 4 8 3 8 4 8 4 3 4 4 4 4 3 3 4 8 7
6 4 3 8 3 8 3 3 3 8 3 4 4 3 3 3 4 4 4 3 4 3 3 3 3 3 8 4 3 3 4 7
6 4 3 3 3 4 4 3 8 4 3 3 4 3 4 3 4 3 3 3 4 3 8 4 3 4 4 4 4 3 3 7
6 4 4 4 4 4 3 3 4 8 3 4 4 3 4 3 4 3 8 4 4 4 4 8 3 3 3 3 4 3 3 7
6 4 3 4 3 3 3 4 4 3 3 4 3 3 8 4 4 4 4 3 3 3 3 8 4 8 3 3 4 8 4 7
6 4 3 8 3 4 8 4 3 3 4 4 4 3 3 3 3 4 3 3 4 4 3 3 3 4 4 3 3 3 4 7
6 4 3 4 3 4 3 3 3 8 4 3 8 4 4 4 3 4 3 4 8 4 8 4 3 3 8 3 4 3 8 7
6 8 3 4 3 4 4 3 4 4 3 3 3 3 3 8 3 4 3 8 3 3 4 8 4 3 4 3 4 8 4 7
6 4 3 3 3 3 4 4 4 4 4 4 4 4 3 4 3 4 3 4 4 3 3 3 3 3 4 3 8 3 3 7
6 4 4 4 8 3 3 3 3 3 3 3 3 3 3 3 3 3 3 3 4 3 4 8 4 3 4 3 4 2 2 7
6 4 4 4 8 8 4 4 4 4 4 8 4 4 4 8 4 4 4 4 8 4 4 3 8 4 4 3 8 2 2 7
3 3 3 3 3 3 3 3 3 3 3 3 3 3 3 3 3 3 3 3 3 3 3 3 3 3 3 3 3 3 3 3